nam_adj	
nam_adj_person	
nam_adj_country	
nam_adj_city	
nam_eve	process
nam_eve_human
nam_eve_human_aniversary	anniversary
nam_eve_human_holiday	holiday, ceremony
nam_eve_human_sport	sport, Contest
nam_eve_human_cultural	performance, demonstrating
nam_eve_natural_phenomenom	Process
nam_fac	StationaryArtifact
nam_fac_bridge	bridge
nam_fac_cossroad	TranstiwayJunction
nam_fac_goe	Building
nam_fac_goe_market	StockMarket
nam_fac_goe_stop	TransitTerminal
nam_fac_park	Park
nam_fac_road	Roadway
nam_fac_square	LandArea
nam_fac_system
nam_liv	Organism
nam_liv_animal	Animal
nam_liv_character	Agent 
nam_liv_god	Agent 
nam_liv_person	Human
nam_oth_person_add	Human
nam_oth_person_first	Human
nam_oth_person_last	Human
nam_liv_habitant	Human
nam_liv_plant	Plant
nam_loc	
nam_loc_astronomical	AstronomicalBody
nam_loc_country_region
nam_loc_gpe
nam_loc_gpe_admin	LandArea
nam_loc_gpe_admin1	StateOrProvince
nam_loc_gpe_admin2	GeopoliticalArea
nam_loc_gpe_admin3	GeopoliticalArea
nam_loc_gpe_city	City
nam_loc_gpe_conurbation
nam_loc_gpe_country	Nation
nam_loc_gpe_district	CityDistrict
nam_loc_gpe_subdivision
nam_loc_historical_region	GeopoliticalArea, LandArea, StateOrProvince
nam_loc_hydronym	WaterArea
nam_loc_hydronym_bay	Gulf, Bay
nam_loc_hydronym_lagoon	StaticWaterArea
nam_loc_hydronym_lake	Lake
nam_loc_hydronym_ocean	Ocean
nam_loc_hydronym_river	StreamWaterArea
nam_loc_hydronym_sea	Sea
nam_loc_land	LandForm
nam_loc_land_cape	Cape
nam_loc_land_continent	Continent
nam_loc_land_desert	Desert
nam_loc_land_island	Island, Archipelago
nam_loc_land_mountain	UplandArea
nam_loc_land_peak	LandArea, Mountain
nam_loc_land_peninsula	Peninsula
nam_loc_land_protected_area	PublicPark
nam_loc_land_region	GeographicArea
nam_loc_land_sandspit	Cape
nam_num
nam_num_postal_code	
nam_num_house
nam_num_flat
nam_num_phone	
nam_org
nam_org_company	Business, CommercialAgent 
nam_org_group	Organization, GroupOfPeople
nam_org_group_band	DramaticCast, MusicalGroup, Organization
nam_org_group_team	SportsTeam
nam_org_nation	Nation, EthnicGroup 
nam_org_organization	Organization 
nam_org_institution	Organization
nam_org_institution_full	Organization
nam_org_organization_sub
nam_org_political_party	PoliticalParty
nam_oth
nam_oth_address_street	PostalAddressText
nam_oth_currency	Currency
nam_oth_data_format	ComputerFile
nam_oth_ip	InternetAddress
nam_oth_license	License
nam_oth_mail	EmailAddress
nam_oth_position	Position
nam_oth_stock_index	StockIndex
nam_oth_tech
nam_oth_www	InternetAddress
nam_pro	Artifact
nam_pro_award	Icon, Guiding, Requestion, UnilateralGiving
nam_pro_brand
nam_pro_media
nam_pro_media_tv	TelevisionStation
nam_pro_media_radio	RadioStation
nam_pro_media_periodic	Periodical
nam_pro_media_web	WebPage, WebSite 
nam_pro_model	Product
nam_pro_model_car	SelfPoweredRoadVehicle
nam_pro_model_phone	Telephone
nam_pro_model_plane	Airplane
nam_pro_model_ship	Ship, FerryBoat, FireBoat, FishingShip, Freighter, KeelBoat, Sailboat, Submarine, TugBoat
nam_pro_software	ComputerProgram
nam_pro_software_os	ComputerProgram
nam_pro_software_game	VideoGame
nam_pro_software_version
nam_pro_title
nam_pro_title_album	Album
nam_pro_title_article	Article
nam_pro_title_boardgame	Game, GameBoard, GameArtifact
nam_pro_title_book	Book
nam_pro_title_document	Text
nam_pro_title_painting	PaintedPicture
nam_pro_title_movie	MotionPicture, BroadcastProgram
nam_pro_title_radio	Disseminating, BroadcastProgram
nam_pro_title_song	Song
nam_pro_title_treaty	TreatyDocument
nam_pro_title_tv	Disseminating, BroadcastProgram
nam_pro_vehicle	Vehicle